.............................................................................................................................
.___________________________________________________________________________________________________________________________.
.____________________________________________________________________________________________________________________M______.
.___________________________________________________________________________________________________________________________.
.____________________________________________________________________________________________________________________M______.
.___________________________________________________________________________________________________________________________.
.___________________________________________________________________________________________________________________________.
.___________________________________________________________________________________________________________________________.
......................................................................................................................._____.
.___________________________________________________________________________________________________________________________.
.____M______________________________________________________________________________________________________________________.
.___________________________________________________________________________________________________________________________.
.____M_________________________________________________N____________________________________________________________________.
.___________________________________________________________________________________________________________________________.
.____M______________________________________________________________________________________________________________________.
.___________________________________________________________________________________________________________________________.
._____.......................................................................................................................
._____________________________________________________________________________________________________________________B____B.
._______________________________M___________________________________________________________________________________________.
.___________________________________________________________________________________________________________________________.
.___________________________________________________________________________________________________________________________.
.________________________M__________________________________________________________________________________________________.
.___________________________________________________________________________________________________________________________.
.___________________________________________________________________________________________________________________________.
._____........................................._____..................................................................._____.
.________________________________________.________________._________________________________________________________________.
.________________________________________.________________._________________________________________________________________.
.________________________________________.________________._________M_______________________________________________________.
.________________________________________.________N_______._________________________________________________________________.
.________________________________________.________________._________________________________________________________________.
.________________________________________._B____________B_._________M_______________________________________________________.
.________________________________________.________________._________________________________________________________________.
......................................................................................................................._____.
.___________________________________________________________________________________B_______________________________________.
.___________________________________________________________________________________________________________________________.
.___________________________________________________________________________________________________________________________.
.___________________________________________________________________________________________________________________________.
.___________________________________________________________________________________________________________________________.
.___________________________________________________________________________________________________________________________.
._________________________________________________B_________________________________________________________________________.
._____.......................................................................................................................
._________________________________B___________________B_______________________________________________________M_____________.
.___________________________________________________________________________________________________________________________.
._____________________________________________________________________________________________________________M_____________.
.___________________________________________________________________________________________________________________________.
._____________________________________________________________________________________________________________M_____________.
.___________________________________________________________________________________________________________________________.
.____________________________________________B________________________________________________________________M_____________.
......................................................................................................................._____.
.___________________________________________________________________________________________________________________________.
._________________________M_________________________________________________________________________________________________.
.___________________________________________________________________________________________________________________________.
._________________________M_______________________________________________________________________________N_________________.
.___________________________________________________________________________________________________________________________.
._________________________M_________________________________________________________________________________________________.
.___________________________________________________________________________________________________________________________.
._____.......................................................................................................................
.___________________________________________________________________________________________________________________________.
._____________________M__________________________________B__________________________________________________________________.
.____________________________________________________________________B______________________________________________________.
.________________M__________________________________________________________________________________________________________.
.__________________________________________________________B________________________________________________________________.
.___________M_______________________________________________________________________________________________________________.
.___________________________________________________________________________________________________________________________.
......................................................................................................................._____.
._____________________________________________________________________________________________________________________._____.
._____________________________M_______________________________________________________________________________________._____.
._____________________________________________________________________________________________________________________._____.
.______________________M______________________________________________________________________________________________._____.
._______________________________M_____________________________________________________________________________________._____.
._____________________________________________________________________________________________________________________._____.
._____________________________________________________________________________________________________________________._____.
._____..........................................................................................................._____._____.
._____________________________________________________________________________________________________________MM.___________.
.______________________________________________________________________________________________________________M.___________.
._______________________________________________________________________________________________________________.___________.
._______________________________________________________________________________________________________________.B____N____B.
._______________________________________________________________________________________________________________.............
.___________________________________________________________________________________________________________________________.
.___________________________________________________________________________________________________________________________.
._....................................................................................................................._____.
.___________________M_______________________________________________________________________________________________________.
.___________________________________________________________________________________________________________________________.
.___________________________________________________________________________________________________________________________.
.____________________________________________________B______________________________________________________________________.
.___________________________________________________________________________________________________________________________.
.___________________________________________________________________________________________________________________________.
.__________________________________________________________________________________M________________________________________.
._____.......................................................................................................................
.___________________________________________________________________________________________________________________________.
.__________________________________________________________________________________________________M________________________.
.___________________________________________________________________________________________________________________________.
.___________________________________________________________________________________________________________________________.
.___________________________________________________________________________________________________________________________.
.__________________________________________________________________________________________________M________________________.
.___________________________________________________________________________________________________________________________.
._____................................................................................................................._____.
.____________________________________________________________________________________________________________________B._____.
.____________________________________________________________________________________________________________M________._____.
._____________________________________________________________________________________________________________________._____.
.__________________________________________________________________N_________________________________________________B._____.
._____________________________________________________________________________________________________________________._____.
.____________________________________________________________________________________________________________M________._____.
.____________________________________________________________________________________________________________________B._____.
._....................................................................................................................._____.
._____________________________________________________M_____________________________________________________________________.
.___________________________________________________________________________________________________________________________.
.___________________________________________________________________________________________________________________________.
._____________________B______B________M_______M_______M_____________________________________________________________________.
.___________________________________________________________________________________________________________________________.
.___________________________________________________________________________________________________________________________.
._____________________________________________________M_____________________________________________________________________.
._____.......................................................................................................................
.___________________________________________________________________________________________________________________________.
._________________________________________________B_M_B_____________________________________________________________________.
.___________________________________________________________________________________________________________________________.
......................................................................................................................._____.
.___________________________________________________________________________________________________________________________.
.___________________________________________________________________________________________________________________________.
.___________________________________________________________________________________________________________________________.
._____.......................................................................................................................
.____B____B___B___B____BB__B________________________________________________________________________________________________.
._____B__B_B_B____B____B_B_B_____BBBBBBBBBBBBBBBBBBBBBBBBBBBBBBBBBBBBBBBBBBBBBBBBBBBBBBBBBBBBBBBBBBBBBBBBBBBBBBB________F___.
.______B____B_____B____B__BB________________________________________________________________________________________________.
.............................................................................................................................